8

1,0|0,0|0,0|0,0|0,0|0,0|0,0|0,0|0,0|1,0|
1,6|0,0|2,0|0,0|2,6|2,6|0,0|2,0|0,0|1,6|
1,0|0,0|0,0|3,6|0,0|0,0|3,6|0,0|0,0|1,0|
1,0|0,0|0,0|0,0|0,0|0,0|0,0|0,0|0,0|1,0|
1,0|0,0|0,0|0,0|0,0|0,0|0,0|0,0|0,0|1,0|
1,7|0,0|0,0|0,0|0,0|0,0|0,0|0,0|0,0|1,7|
1,0|0,0|0,0|0,0|0,0|0,0|0,0|0,0|0,0|1,0|
1,7|0,0|0,0|0,0|0,0|0,0|0,0|0,0|0,0|1,7|
