5

1,0|0,0|0,0|0,0|0,0|0,0|0,0|0,0|0,0|0,0|
0,0|1,0|0,0|0,0|0,0|0,0|0,0|0,0|0,0|0,0|
0,0|0,0|1,0|0,0|0,0|0,0|0,0|0,0|0,0|0,0|
0,0|0,0|0,0|1,0|0,0|0,0|0,0|0,0|0,0|0,0|
0,0|0,0|0,0|0,0|1,0|0,0|0,0|0,0|0,0|0,0|

gauche: resistance, droite: bonus
resistance max: 3
6=barre+
7=score+